0000000000000000
0111111000001140
0010000011111000
0000000050000000
0111001111111100
0101001000000100
0100001510000100
0100001210000100
0111001510100000
0101000100111100
0600000100000100
0111111111600100
0001000000101110
0111063600101010
0001111100111010
0000000000000000